1111111111111111111
100000P000000000001
1001011111000001111
1C01111111000001111
10111E0000000111111
1001111101110100001
1111111111111111111