111111111111
10C000000001
1P000C0E0011
1C000000C001
111111111111