1111111111111111111
1000C000000000001C1
1001011E11000001111
1001111111000001111
10111000P0000111111
1001111111110C00001
1111111111111111111