1111111111111111111
10000000C0000001111
1001011111000001111
10011111C1000001111
10010E00P1000001111
10011111111100000C1
1111111111111111111