1111111111
1P00000001
100C0C0C01
1000000C01
1C0C0C0001
1000000C01
100C0C0C01
1000000C01
1E00000001
1111111111