1111111111
1P10000001
101C0C0C01
1000000C01
1E0C0C0001
1000000C01
100C0C0C01
1000000C01
1000000001
1111111111