11111111111111111111
1P000000000C00000001
10000000000000000001
10000000000000000001
10000000000000000001
10000000000000000001
100000000000000000E1
10000000000000000001
10000000000000000001
10000000000000000001
10000000000000000001
10000000000000000001
10000000000000000001
100000000C0000000001
10000000000000000001
10000000000000000001
100000000000C0000001
10000000000000000001
1000C000000000000001
11111111111111111111