1111111
1P00001
101C101
1E00001
1111111