111111111
1P0000001
101111011
100C00C01
101111011
1C0000C01
101111011
1E0000001
111111111