111111111111111111111111111111111111111
1P00000C000000000000C0000000000000C0001
101111111111111111101111111111111111111
1000000C0000000000C00000000000000C00001
101111111111111111111110111111111111111
1C00000000000C0000000000C000000000000C1
101111111111111111111111111111011111111
1C0000000C000000000000C000000000C000001
101111111111111111111111111111111111111
1C000000000000000CC00000000C000000000C1
101111111111111111111111111111111111111
100C00000000000C00000000000C00000000001
101111111111111111111111111111111111111
1C000000000000C0000000000C00000000000E1
111111111111111111111111111111111111111