11111111111111111111
1P000000000000000001
10000000000000000001
10000000000000000001
10000000000000000001
10000000000000000001
100000000000000000E1
10000000000000000001
10000000000000000001
10000000000000000001
10000000000000000001
10000000000000000001
10000000000000000001
10000000000000000001
10000000000000000001
10000000000000000001
10000000000000000001
10011100000000000001
1001C100000000000001
11111111111111111111