111111111111111
1P00000000000C1
100111011111001
10C00000000C01
10111101111101
10000000000001
10111101111101
10C00000000C01
100000000000E1
111111111111111