1111111111111111111
10000000000T0000001
100T00PC00001T00001
1001011111001111111
1C01111111000001111
10111E0C00T00111111
1001111101110100001
1111111111111111111