1111111111111111111
100P000000000000001
100T101C00001000001
1001101111001111111
1C011T1111000001111
10111C0E10T00111111
1001111101110100001
1111111111111111111