1111111111111111111
10T000T0000T0000001
100T00PC00001T00001
10T1011111001111111
1C01111111000001111
10111E0CT0T0T111111
1001111101110100001
1111111111111111111