1111111111111111111
1111111111111111111
100000PC00000000001
1001011111000001111
1C01111111000001111
10111E000000T111111
1001111101110100001
1111111111111111111