1111111111111111111
1111111111111111111
100000PC00000T00001
1001011111000001111
1C01111111000001111
10111E0C0000T111111
1001111101110100001
1111111111111111111